#Fairyground Variant Settings File
#Syntax: <variant ID (delcared in variants.ini)>|<variant type/classification>|<variant display name>|<variant description>
#The type or classification is used in variant type dropdown which helps you classify the variants.
#The display name will be displayed in the variant dropdown as the item name.
#The description will be displayed in the dropdown as tooltips, you can hover your cursor on an item to view that.
#This can also be accessed from <About This Variant> button.

chess|Chess Variants|Chess|Chess, unmodified, as it's played by FIDE standards.
crazyhouse|Chess Variants|Crazy House|Take captured pieces and drop them back on to the board as your own.
atomic|Chess Variants|Atomic Chess|Pieces explode upon capture, destroying all pieces except pawns in the 8 square around the destination square and itself.
kingofthehill|Chess Variants|King Of The Hill|Bring your King to the center to win the game.
3check|Chess Variants|3 Check|Check your opponent 3 times to win the game.
placement|Chess Variants|Placement Chess|Choose where your pieces start.
duck|Chess Variants|Duck Chess|The duck (a wall square that blocks any piece from moving to it) must be moved to a new square after every turn.
racingkings|Chess Variants|Racing Kings|Hinder the opponent's king and make your king reach the 8th rank first to win. Checks are not allowed.
giveaway|Chess Variants|Giveaway Chess|Lose all your pieces or get stalemated to win. Capturing is compulsory.
torpedo|Chess Variants|Torpedo|Pawns can always move forward one or two squares.
nocastle|Chess Variants|No Castling|Castling is not allowed.
pawnsideways|Chess Variants|Pawns Sideways|Pawns can also move sideways one square.
knightmate|Chess Variants|Knight Mate|The king moves like a knight while the knights move like a king.

makruk|Makruk Variants|Makruk|Thai Chess. A game closely resembling the original Chaturanga. Similar to Chess but with a different queen and bishop.
makpong|Makruk Variants|Makpong|Makruk variant where kings cannot move to escape out of check.
cambodian|Makruk Variants|Cambodian Chess|Makruk with a few additional opening abilities.
sittuyin|Makruk Variants|Sittuyin|Burmese Chess. Similar to Makruk, but pieces are placed at the start of the match.
asean|Makruk Variants|Asean|Makruk using the board/pieces from International Chess as well as pawn promotion rules.

shogi|Shogi Variants|Shogi|Japanese Chess, the standard 9x9 version played today with drops and promotions.
minishogi|Shogi Variants|Mini Shogi|5x5 Shogi for more compact and faster games. There are no knights or lances.
kyotoshogi|Shogi Variants|Kyoto Shogi|A wild Shogi variant on a 5x5 board where pieces flip into a different piece after each move.
dobutsu|Shogi Variants|Dobutsu|3x4 game with cute animals, designed to teach children how to play Shogi.
gorogoroplus|Shogi Variants|Gorogoro+|5x6 Shogi designed to introduce tactics with the generals.
torishogi|Shogi Variants|Tori Shogi|A confrontational 7x7 variant with unique pieces each named after different birds.
shoshogi|Shogi Variants|Sho Shogi|A new piece called Drunk Elephant is introduced, which can promote to a new king. You can lose one of the 2 kings after the promotion.

xiangqi|Xiangqi Variants|Xiangqi|Chinese Chess, one of the oldest and most played board games in the world.
manchu|Xiangqi Variants|Manchu Xiangqi|Xiangqi variant where one side has a chariot that can also move as a cannon or horse.
janggi|Xiangqi Variants|Janggi|Korean Chess, similar to Xiangqi but plays much differently. Tournament rules are used.
minixiangqi|Xiangqi Variants|Mini Xiangqi|Compact version of Xiangqi played on a 7x7 board without a river.

capablanca|Fairy Variants|Capablanca Chess|Play with the hybrid pieces, archbishop (B+N) and chancellor (R+N), on a 10x8 board.
capahouse|Fairy Variants|Capablanca House|Capablanca with Crazyhouse drop rules.
seirawan|Fairy Variants|Seirawan Chess|S-Chess. Hybrid pieces, the hawk (B+N) and elephant (R+N), can enter the board after moving a back rank piece.
shouse|Fairy Variants|Seirawan House|S-Chess with Crazyhouse drop rules.
grand|Fairy Variants|Grand Chess|Play with the hybrid pieces, archbishop (B+N) and chancellor (R+N), on a grand 10x10 board.
grandhouse|Fairy Variants|Grand House|Grand Chess with Crazyhouse drop rules.
shako|Fairy Variants|Shako|Introduces the cannon and elephant from Xiangqi into a 10x10 chess board.
shogun|Fairy Variants|Shogun|Pieces promote and can be dropped, similar to Shogi.
hoppelpoppel|Fairy Variants|Hoppel-Poppel|Knights capture as bishops; bishops capture as knights.
amazon|Fairy Variants|Amazon|Replace the Queen with Amazon (Q + N).
gothic|Fairy Variants|Gothic Chess|Gothic chess. Capablanca chess with better starting positon.
chaturanga|Fairy Variants|Chaturanga|Ancient form of chess. Pawns, bishops(elephants), and queen(ferz) are different from the ones in modern chess.
chak|Fairy Variants|Chak|Mayan chess. Inspired by cultural elements of Mesoamerica.
chennis|Fairy Variants|Chennis|Pieces alternate between two forms with each move.

orda|Army Variants|Orda Chess|Asymmetric variant where one army has pieces that move like knights but capture differently.
synochess|Army Variants|Syno Chess|Asymmetric East vs. West variant which pits the western Chess army against a Xiangqi and Janggi-styled army.
shinobiplus|Army Variants|Shinobi+|Asymmetric variant which pits the western Chess army against a drop-based, Shogi-styled army.
empire|Army Variants|Empire Chess|Asymmetric variant where one army has pieces that move like queens but capture as usual.
ordamirror|Army Variants|Orda Mirror|Orda Chess variant with two Horde armies. The Falcon replaces the Yurt.
spartan|Army Variants|Spartan|Asymmetric Spartans vs. Persians variant.
horde|Army Variants|Horde|Lots of pawns VS chess army. White wins when checkmating black while black wins when capturing all white pieces.

ataxx|Rule Variants|ATAXX|Infection game. Pieces can turn the enemy pieces in the 8 squares around the destination square into friendly pieces after move.
snailtrail|Rule Variants|Snail Trail|The squares that pieces have moved from will be blocked. The one who gets stuck loses.

